A B B B B B B B B B
A B B B A A A A A A
A C C C A B B B B A
A B B B A B B B B A
A A A A A C C C C A
C B B B N B B C B A
C B B B N B B C B A
C B B B N B B C B A
C N N N N N N N N A
B B B B B B B B B A